1111111111111
1C010000000C1
1000011111001
1P0011E000001
111111C111111
1111111111111
1111111111111
1111111111111
1111111111101
1111111111111