1111111111111
1C01000001111
1000011111001
1P0011E000001
1111111111111