11111111111111
1C01000X0000C1
10000000000001
11000010000001
10000111101X01
1P0011E0000001
11111111111111
